"year","month","keyword","total_tweets","num_rt","num_not_rt","num_unique_tweets","num_unique_users"
"2018","11","murray darling","540","421","119","158","403"
"2018","11","murray-darling","458","348","110","135","367"
"2018","11","murray river","301","85","216","231","207"
"2018","11","mdba","287","142","145","196","192"
"2018","11","murraydarling","244","165","79","107","150"
"2018","11","mdbp","137","72","65","104","123"
"2018","11","basin plan","135","73","62","82","98"
"2018","11","basin authority","97","87","10","20","89"
"2018","11","murrayriver","83","29","54","60","66"
"2018","11","basinplan","47","24","23","26","26"
"2018","11","riverdarling","38","20","18","34","7"
"2018","11","river murray","35","13","22","26","30"
"2018","11","rivermurray","23","11","12","12","18"
"2018","11","basinauthority","1","0","1","1","1"
"2018","12","murray-darling","1264","991","273","316","784"
"2018","12","murray darling","808","636","172","207","598"
"2018","12","murraydarling","517","419","98","151","297"
"2018","12","basin plan","372","254","118","153","257"
"2018","12","basin authority","349","307","42","44","307"
"2018","12","mdba","338","210","128","209","259"
"2018","12","murray river","293","115","178","196","229"
"2018","12","mdbp","165","89","76","131","111"
"2018","12","basinplan","92","42","50","55","50"
"2018","12","murrayriver","87","34","53","57","68"
"2018","12","rivermurray","29","13","16","16","23"
"2018","12","riverdarling","26","24","2","10","19"
"2018","12","river murray","25","7","18","18","21"
"2018","12","river darling","1","1","0","1","1"
"2019","1","murraydarling","20983","17843","3140","3948","4152"
"2019","1","murray-darling","18572","15472","3100","3681","4935"
"2019","1","murray darling","18427","15947","2480","3052","4915"
"2019","1","basin plan","4016","3425","591","742","1803"
"2019","1","mdba","3216","2440","776","1063","1249"
"2019","1","basin authority","1922","1531","391","459","1097"
"2019","1","murray river","1409","966","443","532","993"
"2019","1","mdbp","1184","651","533","619","716"
"2019","1","murrayriver","408","299","109","131","354"
"2019","1","basinplan","367","290","77","93","245"
"2019","1","river murray","139","88","51","62","123"
"2019","1","riverdarling","35","34","1","11","29"
"2019","1","river darling","12","4","8","9","10"
"2019","1","basinauthority","12","3","9","9","9"
"2019","1","rivermurray","10","3","7","8","9"
"2019","2","murray-darling","9389","7735","1654","2025","3663"
"2019","2","murraydarling","8091","6567","1524","2091","2516"
"2019","2","murray darling","6289","5159","1130","1485","2550"
"2019","2","mdba","2528","2015","513","739","1291"
"2019","2","basin plan","1862","1479","383","515","1008"
"2019","2","basin authority","813","693","120","151","611"
"2019","2","mdbp","691","506","185","269","501"
"2019","2","murray river","579","292","287","315","444"
"2019","2","river murray","537","456","81","91","369"
"2019","2","basinplan","252","187","65","72","156"
"2019","2","murrayriver","86","27","59","62","70"
"2019","2","rivermurray","63","37","26","29","47"
"2019","2","basinauthority","27","23","4","6","25"
"2019","2","river darling","7","5","2","3","7"
"2019","2","riverdarling","3","3","0","3","3"
"2019","3","murray darling","2949","2478","471","608","1688"
"2019","3","murraydarling","2638","2162","476","727","1137"
"2019","3","murray-darling","2140","1543","597","734","1204"
"2019","3","mdba","658","428","230","332","443"
"2019","3","murray river","577","367","210","244","486"
"2019","3","basin plan","548","401","147","190","364"
"2019","3","mdbp","408","286","122","185","321"
"2019","3","basin authority","235","185","50","68","196"
"2019","3","basinplan","121","75","46","53","70"
"2019","3","river murray","107","73","34","40","94"
"2019","3","murrayriver","81","40","41","48","69"
"2019","3","rivermurray","15","3","12","12","8"
"2019","3","riverdarling","14","14","0","8","9"
"2019","4","murray-darling","7045","5794","1251","1506","2405"
"2019","4","murray darling","5995","5302","693","883","2922"
"2019","4","murraydarling","5275","4248","1027","1383","1752"
"2019","4","basin plan","1846","1505","341","413","1086"
"2019","4","mdba","1667","1324","343","531","907"
"2019","4","mdbp","583","414","169","257","408"
"2019","4","murray river","361","151","210","225","306"
"2019","4","river murray","180","144","36","43","166"
"2019","4","basin authority","145","118","27","34","128"
"2019","4","murrayriver","117","54","63","70","92"
"2019","4","basinplan","114","85","29","36","87"
"2019","4","rivermurray","9","3","6","7","9"
"2019","4","river darling","3","3","0","1","3"
"2019","4","basinauthority","1","0","1","1","1"
"2019","5","murray darling","3244","2737","507","660","1883"
"2019","5","murray-darling","2167","1625","542","663","1306"
"2019","5","murraydarling","1233","869","364","501","634"
"2019","5","basin authority","1025","931","94","107","840"
"2019","5","basin plan","584","457","127","155","458"
"2019","5","mdba","570","363","207","296","383"
"2019","5","mdbp","450","323","127","205","342"
"2019","5","murray river","321","144","177","214","262"
"2019","5","murrayriver","83","35","48","57","63"
"2019","5","river murray","81","37","44","46","70"
"2019","5","basinplan","59","33","26","29","34"
"2019","5","rivermurray","9","2","7","7","7"
"2019","5","riverdarling","4","4","0","1","4"
"2019","5","river darling","4","1","3","3","4"
"2019","5","basinauthority","1","1","0","1","1"
"2019","6","murray darling","1086","883","203","259","733"
"2019","6","murray river","815","544","271","311","570"
"2019","6","murray-darling","658","514","144","182","520"
"2019","6","murraydarling","543","429","114","180","331"
"2019","6","mdba","475","353","122","218","370"
"2019","6","mdbp","202","143","59","92","181"
"2019","6","basin plan","107","70","37","44","93"
"2019","6","murrayriver","80","26","54","58","56"
"2019","6","basin authority","49","34","15","19","47"
"2019","6","river murray","27","5","22","23","21"
"2019","6","basinplan","17","10","7","9","12"
"2019","6","rivermurray","9","0","9","9","6"
"2019","6","riverdarling","1","1","0","1","1"
"2019","7","murray darling","4838","4037","801","1011","2153"
"2019","7","murray-darling","4768","3948","820","1001","2002"
"2019","7","basin plan","3339","2936","403","483","1615"
"2019","7","murraydarling","3305","2764","541","722","1345"
"2019","7","mdba","1063","770","293","404","609"
"2019","7","mdbp","749","551","198","299","472"
"2019","7","murray river","700","519","181","218","558"
"2019","7","basin authority","439","415","24","41","375"
"2019","7","basinplan","212","153","59","65","136"
"2019","7","murrayriver","80","24","56","68","43"
"2019","7","river murray","35","12","23","24","29"
"2019","7","rivermurray","9","1","8","8","7"
"2019","7","riverdarling","8","8","0","6","6"
"2019","8","murray darling","1253","1019","234","312","811"
"2019","8","murraydarling","1096","933","163","238","711"
"2019","8","murray-darling","1010","710","300","373","709"
"2019","8","basin plan","620","472","148","186","444"
"2019","8","mdba","313","191","122","189","235"
"2019","8","mdbp","199","127","72","124","178"
"2019","8","murray river","198","90","108","127","164"
"2019","8","basin authority","47","38","9","13","47"
"2019","8","river murray","40","13","27","27","28"
"2019","8","murrayriver","39","6","33","38","26"
"2019","8","rivermurray","25","14","11","11","19"
"2019","8","basinplan","24","15","9","13","19"
"2019","8","riverdarling","3","3","0","2","3"
"2019","8","basinauthority","1","0","1","1","1"
"2019","9","murray-darling","1887","1558","329","417","1204"
"2019","9","murray darling","1523","1291","232","323","996"
"2019","9","murraydarling","895","712","183","266","534"
"2019","9","murray river","800","583","217","253","607"
"2019","9","mdba","606","442","164","254","450"
"2019","9","basin plan","424","300","124","150","325"
"2019","9","mdbp","223","164","59","109","206"
"2019","9","river murray","58","22","36","37","33"
"2019","9","basinplan","51","28","23","26","37"
"2019","9","basin authority","50","39","11","14","46"
"2019","9","murrayriver","44","8","36","39","27"
"2019","9","rivermurray","10","5","5","6","10"
"2019","9","riverdarling","2","2","0","1","2"
"2019","10","murray-darling","2901","2353","548","660","1525"
"2019","10","murray darling","2522","2072","450","630","1333"
"2019","10","mdba","1413","1157","256","402","841"
"2019","10","murraydarling","1296","860","436","547","590"
"2019","10","basin plan","823","671","152","182","572"
"2019","10","murray river","666","473","193","233","495"
"2019","10","basin authority","609","494","115","145","453"
"2019","10","mdbp","302","173","129","200","231"
"2019","10","river murray","114","73","41","43","92"
"2019","10","basinplan","73","47","26","33","50"
"2019","10","murrayriver","62","15","47","50","49"
"2019","10","riverdarling","28","27","1","5","28"
"2019","10","rivermurray","8","1","7","7","7"
"2019","10","river darling","3","0","3","3","2"
"2019","10","basinauthority","2","1","1","1","2"
"2019","11","murray darling","1041","804","237","350","677"
"2019","11","murray-darling","998","707","291","372","663"
"2019","11","murraydarling","870","693","177","237","539"
"2019","11","basin plan","508","383","125","163","352"
"2019","11","mdba","411","277","134","217","308"
"2019","11","mdbp","316","220","96","131","267"
"2019","11","murray river","311","132","179","194","248"
"2019","11","basin authority","116","96","20","32","105"
"2019","11","river murray","82","32","50","55","70"
"2019","11","murrayriver","46","11","35","41","31"
"2019","11","basinplan","37","19","18","20","20"
"2019","11","rivermurray","25","8","17","17","18"
"2019","11","riverdarling","9","9","0","4","8"
"2019","12","murray-darling","1953","1391","562","674","1093"
"2019","12","basin plan","1318","962","356","446","741"
"2019","12","murray darling","1310","968","342","452","878"
"2019","12","murraydarling","894","676","218","286","552"
"2019","12","mdba","523","371","152","246","401"
"2019","12","mdbp","424","268","156","213","328"
"2019","12","murray river","363","182","181","211","290"
"2019","12","river murray","121","92","29","32","102"
"2019","12","basinplan","99","51","48","54","56"
"2019","12","murrayriver","56","9","47","47","37"
"2019","12","basin authority","30","15","15","22","28"
"2019","12","basinauthority","8","5","3","4","7"
"2019","12","rivermurray","5","2","3","4","5"
"2019","12","riverdarling","5","5","0","2","5"
"2019","12","river darling","2","1","1","2","2"
"2020","1","murray-darling","1601","1324","277","350","1055"
"2020","1","murray darling","1114","856","258","342","819"
"2020","1","murraydarling","555","405","150","197","359"
"2020","1","mdba","467","339","128","187","352"
"2020","1","murray river","416","230","186","217","343"
"2020","1","basin plan","225","183","42","57","185"
"2020","1","mdbp","134","68","66","98","119"
"2020","1","basin authority","81","60","21","29","75"
"2020","1","murrayriver","74","21","53","58","52"
"2020","1","river murray","55","37","18","19","47"
"2020","1","rivermurray","15","9","6","8","14"
"2020","1","basinplan","13","5","8","8","10"
"2020","1","basinauthority","3","1","2","3","3"
"2020","1","riverdarling","2","2","0","1","2"
"2020","1","river darling","1","0","1","1","1"
"2020","2","murray-darling","1192","875","317","386","798"
"2020","2","murray darling","866","708","158","256","587"
"2020","2","murraydarling","462","321","141","191","270"
"2020","2","basin plan","349","275","74","99","290"
"2020","2","mdba","348","247","101","198","246"
"2020","2","murray river","322","171","151","168","260"
"2020","2","mdbp","295","220","75","124","242"
"2020","2","basin authority","102","99","3","5","100"
"2020","2","river murray","39","19","20","23","34"
"2020","2","murrayriver","38","4","34","36","21"
"2020","2","basinplan","17","12","5","9","12"
"2020","2","rivermurray","3","0","3","3","3"
"2020","2","basinauthority","2","0","2","2","1"
"2020","2","river darling","1","0","1","1","1"
"2020","3","murray darling","750","652","98","143","555"
"2020","3","murraydarling","397","336","61","92","302"
"2020","3","murray-darling","370","263","107","136","299"
"2020","3","mdba","310","191","119","196","237"
"2020","3","murray river","167","57","110","123","142"
"2020","3","mdbp","160","89","71","110","145"
"2020","3","basin plan","111","79","32","43","94"
"2020","3","murrayriver","63","21","42","46","38"
"2020","3","river murray","37","13","24","25","28"
"2020","3","basin authority","20","12","8","8","20"
"2020","3","rivermurray","7","3","4","4","7"
"2020","3","basinplan","7","2","5","5","6"
"2020","3","riverdarling","1","1","0","1","1"
"2020","4","murray darling","991","775","216","283","683"
"2020","4","murray-darling","812","638","174","204","645"
"2020","4","murraydarling","336","256","80","94","257"
"2020","4","mdba","332","221","111","176","270"
"2020","4","murray river","316","140","176","188","236"
"2020","4","mdbp","168","109","59","101","157"
"2020","4","basin plan","155","104","51","56","127"
"2020","4","river murray","83","50","33","34","55"
"2020","4","murrayriver","35","4","31","32","19"
"2020","4","basin authority","26","18","8","12","22"
"2020","4","rivermurray","17","12","5","6","16"
"2020","4","basinplan","8","4","4","4","6"
"2020","5","murray-darling","1523","1182","341","394","1007"
"2020","5","murray darling","594","474","120","195","388"
"2020","5","murray river","363","189","174","192","298"
"2020","5","mdba","268","153","115","185","197"
"2020","5","murraydarling","259","155","104","125","180"
"2020","5","mdbp","157","100","57","104","142"
"2020","5","basin plan","145","95","50","69","117"
"2020","5","river murray","118","79","39","47","106"
"2020","5","basin authority","54","45","9","11","52"
"2020","5","murrayriver","38","3","35","36","18"
"2020","5","basinplan","7","2","5","5","5"
"2020","5","rivermurray","6","2","4","4","6"
"2020","6","murray-darling","444","295","149","186","317"
"2020","6","murray darling","370","294","76","123","291"
"2020","6","mdba","281","197","84","183","211"
"2020","6","murray river","249","109","140","153","210"
"2020","6","basin plan","246","170","76","93","177"
"2020","6","murraydarling","216","146","70","96","127"
"2020","6","mdbp","114","67","47","88","109"
"2020","6","murrayriver","66","3","63","63","27"
"2020","6","basinplan","58","32","26","26","22"
"2020","6","river murray","40","11","29","31","35"
"2020","6","basin authority","18","10","8","11","18"
"2020","6","rivermurray","9","2","7","7","6"
"2020","7","murray-darling","873","690","183","224","653"
"2020","7","murray river","611","307","304","337","502"
"2020","7","murraydarling","457","386","71","97","328"
"2020","7","murray darling","386","305","81","123","312"
"2020","7","mdbp","242","187","55","92","228"
"2020","7","mdba","167","101","66","117","139"
"2020","7","river murray","150","102","48","54","126"
"2020","7","basin plan","91","63","28","38","72"
"2020","7","murrayriver","88","25","63","66","52"
"2020","7","rivermurray","22","13","9","11","18"
"2020","7","basinplan","18","7","11","12","11"
"2020","7","basin authority","6","2","4","5","6"
"2020","8","murray-darling","741","614","127","172","563"
"2020","8","murraydarling","703","636","67","85","543"
"2020","8","murray darling","458","370","88","130","363"
"2020","8","mdba","263","175","88","172","212"
"2020","8","murray river","223","57","166","176","165"
"2020","8","basin plan","170","127","43","56","130"
"2020","8","basin authority","97","72","25","26","84"
"2020","8","mdbp","75","35","40","62","71"
"2020","8","murrayriver","59","11","48","51","21"
"2020","8","river murray","36","10","26","28","32"
"2020","8","rivermurray","28","17","11","12","22"
"2020","8","basinplan","6","2","4","4","5"
"2020","9","murray-darling","1195","839","356","431","788"
"2020","9","murray darling","834","677","157","218","634"
"2020","9","murraydarling","780","643","137","189","533"
"2020","9","murray river","351","141","210","231","255"
"2020","9","basin plan","295","221","74","92","241"
"2020","9","mdba","285","158","127","193","220"
"2020","9","mdbp","144","89","55","100","119"
"2020","9","basin authority","79","56","23","27","74"
"2020","9","murrayriver","61","12","49","51","32"
"2020","9","basinplan","58","43","15","18","45"
"2020","9","river murray","25","9","16","16","22"
"2020","9","rivermurray","9","5","4","6","8"
"2020","10","murray darling","714","621","93","146","611"
"2020","10","murray-darling","306","212","94","110","271"
"2020","10","mdba","264","149","115","185","170"
"2020","10","murray river","263","105","158","168","192"
"2020","10","murraydarling","228","161","67","82","168"
"2020","10","basin authority","124","110","14","17","119"
"2020","10","basin plan","124","98","26","34","112"
"2020","10","mdbp","112","68","44","76","107"
"2020","10","river murray","57","32","25","28","43"
"2020","10","murrayriver","49","7","42","45","20"
"2020","10","basinplan","16","9","7","7","13"
"2020","10","rivermurray","15","7","8","8","9"
"2020","11","murray-darling","566","388","178","211","458"
"2020","11","basin plan","371","224","147","169","310"
"2020","11","murray darling","299","229","70","105","260"
"2020","11","murray river","249","110","139","155","208"
"2020","11","mdba","194","125","69","118","170"
"2020","11","murraydarling","170","118","52","65","114"
"2020","11","mdbp","95","37","58","80","84"
"2020","11","murrayriver","53","8","45","46","25"
"2020","11","river murray","47","25","22","23","42"
"2020","11","basinplan","17","7","10","10","11"
"2020","11","basin authority","17","13","4","8","17"
"2020","11","river darling","1","0","1","1","1"
"2020","12","murray-darling","599","402","197","227","453"
"2020","12","murray darling","395","290","105","138","317"
"2020","12","murray river","370","169","201","217","298"
"2020","12","mdba","303","150","153","221","199"
"2020","12","mdbp","239","185","54","89","228"
"2020","12","murraydarling","214","150","64","75","146"
"2020","12","basin plan","184","80","104","117","133"
"2020","12","basin authority","74","49","25","31","72"
"2020","12","river murray","53","19","34","35","34"
"2020","12","murrayriver","51","6","45","47","24"
"2020","12","basinplan","18","8","10","10","16"
"2020","12","rivermurray","2","0","2","2","2"
"2021","1","murraydarling","812","740","72","88","482"
"2021","1","murray river","586","200","386","411","396"
"2021","1","murray darling","418","319","99","117","319"
"2021","1","mdba","374","199","175","268","276"
"2021","1","mdbp","247","165","82","152","217"
"2021","1","murray-darling","242","167","75","80","201"
"2021","1","basin plan","112","91","21","23","88"
"2021","1","murrayriver","101","26","75","84","56"
"2021","1","river murray","32","15","17","17","31"
"2021","1","riverdarling","22","18","4","4","17"
"2021","1","basin authority","11","7","4","4","11"
"2021","1","rivermurray","6","3","3","3","6"
"2021","1","basinplan","2","0","2","2","1"
"2021","1","river darling","1","0","1","1","1"
"2021","2","murray darling","962","794","168","192","732"
"2021","2","murray-darling","646","480","166","189","481"
"2021","2","mdba","605","371","234","328","388"
"2021","2","murray river","598","290","308","346","425"
"2021","2","murraydarling","592","457","135","158","334"
"2021","2","murrayriver","232","103","129","165","105"
"2021","2","basin plan","228","168","60","67","154"
"2021","2","mdbp","145","66","79","121","132"
"2021","2","river murray","64","34","30","31","59"
"2021","2","basin authority","35","21","14","15","33"
"2021","2","basinplan","16","4","12","12","7"
"2021","2","rivermurray","14","6","8","8","13"
"2021","2","riverdarling","8","5","3","3","6"
"2021","2","river darling","1","0","1","1","1"
"2021","3","murray darling","936","704","232","258","712"
"2021","3","murray-darling","847","639","208","238","649"
"2021","3","murraydarling","503","376","127","145","322"
"2021","3","mdba","461","245","216","328","294"
"2021","3","murray river","360","146","214","223","289"
"2021","3","basin plan","229","147","82","95","178"
"2021","3","mdbp","205","92","113","153","186"
"2021","3","basin authority","128","119","9","9","121"
"2021","3","murrayriver","75","17","58","61","41"
"2021","3","river murray","68","35","33","33","43"
"2021","3","rivermurray","16","10","6","10","15"
"2021","3","basinplan","4","4","0","3","4"
"2021","3","river darling","2","0","2","2","2"
"2021","4","murray darling","613","444","169","191","477"
"2021","4","murray-darling","555","406","149","159","420"
"2021","4","murray river","420","231","189","204","312"
"2021","4","mdba","388","197","191","273","251"
"2021","4","murraydarling","303","243","60","75","217"
"2021","4","mdbp","147","84","63","114","135"
"2021","4","basin plan","135","90","45","55","100"
"2021","4","murrayriver","93","30","63","66","51"
"2021","4","basin authority","47","36","11","13","46"
"2021","4","river murray","43","17","26","28","35"
"2021","4","rivermurray","20","13","7","7","15"
"2021","4","basinplan","1","0","1","1","1"
"2021","5","murray-darling","936","714","222","241","646"
"2021","5","murray darling","878","748","130","155","734"
"2021","5","mdba","627","336","291","393","379"
"2021","5","basin plan","354","257","97","110","272"
"2021","5","murraydarling","330","214","116","128","240"
"2021","5","murray river","313","150","163","177","272"
"2021","5","mdbp","273","195","78","131","258"
"2021","5","murrayriver","74","15","59","61","38"
"2021","5","basin authority","60","47","13","14","58"
"2021","5","river murray","42","19","23","25","31"
"2021","5","rivermurray","24","16","8","10","17"
"2021","5","riverdarling","6","5","1","1","6"
"2021","5","basinplan","1","0","1","1","1"
"2021","6","murray darling","4700","4327","373","420","2443"
"2021","6","basin plan","4311","3979","332","354","2176"
"2021","6","murray-darling","2346","1963","383","420","1499"
"2021","6","murraydarling","1128","945","183","235","664"
"2021","6","mdba","506","276","230","330","345"
"2021","6","river murray","501","466","35","38","471"
"2021","6","murray river","460","229","231","251","378"
"2021","6","mdbp","266","139","127","187","229"
"2021","6","basin authority","93","85","8","9","91"
"2021","6","basinplan","66","51","15","20","48"
"2021","6","murrayriver","37","2","35","35","20"
"2021","6","rivermurray","18","7","11","11","12"
"2021","6","basinauthority","1","0","1","1","1"
"2021","6","river darling","1","0","1","1","1"
"2021","7","murraydarling","679","577","102","317","399"
"2021","7","murray darling","626","478","148","180","505"
"2021","7","mdba","573","410","163","246","459"
"2021","7","murray river","418","195","223","240","324"
"2021","7","murray-darling","417","290","127","152","333"
"2021","7","basinplan","265","240","25","202","193"
"2021","7","mdbp","164","78","86","135","149"
"2021","7","basin plan","70","45","25","31","63"
"2021","7","river murray","66","29","37","41","51"
"2021","7","murrayriver","52","10","42","46","30"
"2021","7","rivermurray","30","20","10","10","19"
"2021","7","basin authority","20","18","2","6","20"
"2021","8","murraydarling","824","699","125","440","469"
"2021","8","murray darling","762","589","173","192","594"
"2021","8","murray-darling","757","573","184","203","576"
"2021","8","murray river","497","266","231","259","419"
"2021","8","mdba","390","205","185","271","274"
"2021","8","basinplan","386","352","34","335","235"
"2021","8","mdbp","215","140","75","114","192"
"2021","8","basin plan","174","120","54","60","167"
"2021","8","murrayriver","100","57","43","45","84"
"2021","8","river murray","67","23","44","47","36"
"2021","8","basin authority","60","52","8","9","57"
"2021","8","rivermurray","26","16","10","10","13"
"2021","9","murray-darling","680","565","115","138","486"
"2021","9","murraydarling","661","554","107","202","342"
"2021","9","murray river","559","257","302","322","404"
"2021","9","mdba","500","333","167","247","364"
"2021","9","murray darling","428","280","148","168","325"
"2021","9","mdbp","233","139","94","144","201"
"2021","9","basin plan","228","171","57","65","158"
"2021","9","basinplan","101","96","5","88","77"
"2021","9","murrayriver","76","14","62","65","38"
"2021","9","river murray","53","16","37","38","31"
"2021","9","rivermurray","20","9","11","11","13"
"2021","9","basin authority","19","11","8","9","18"
"2021","9","river darling","1","0","1","1","1"
"2021","10","murraydarling","1012","905","107","169","668"
"2021","10","murray darling","892","720","172","197","734"
"2021","10","murray-darling","825","664","161","178","679"
"2021","10","basin plan","685","632","53","61","558"
"2021","10","murray river","463","207","256","269","341"
"2021","10","mdba","407","239","168","257","326"
"2021","10","mdbp","233","137","96","154","206"
"2021","10","murrayriver","82","22","60","64","42"
"2021","10","river murray","79","49","30","30","72"
"2021","10","basinplan","57","48","9","44","48"
"2021","10","rivermurray","26","9","17","17","13"
"2021","10","basin authority","17","8","9","10","16"
"2021","10","river darling","1","0","1","1","1"
"2021","11","mdba","657","479","178","300","575"
"2021","11","murray river","479","243","236","246","344"
"2021","11","murray-darling","339","207","132","146","285"
"2021","11","murray darling","271","194","77","86","239"
"2021","11","mdbp","228","140","88","153","216"
"2021","11","murraydarling","206","161","45","55","156"
"2021","11","murrayriver","75","27","48","52","45"
"2021","11","basin plan","69","50","19","23","68"
"2021","11","river murray","50","24","26","26","43"
"2021","11","rivermurray","29","17","12","13","19"
"2021","11","basinplan","14","4","10","11","9"
"2021","11","basin authority","4","1","3","3","4"
"2021","12","murray river","720","425","295","310","573"
"2021","12","murray darling","522","444","78","93","466"
"2021","12","mdba","358","180","178","278","289"
"2021","12","murray-darling","339","255","84","94","290"
"2021","12","murraydarling","262","189","73","91","130"
"2021","12","mdbp","249","163","86","162","226"
"2021","12","murrayriver","84","28","56","60","52"
"2021","12","river murray","70","44","26","30","52"
"2021","12","basin plan","63","45","18","20","54"
"2021","12","rivermurray","19","9","10","11","14"
"2021","12","basin authority","15","6","9","9","15"
"2021","12","basinplan","3","0","3","3","1"
"2021","12","river darling","1","1","0","1","1"
"2022","1","murray darling","618","529","89","106","553"
"2022","1","murray-darling","463","337","126","137","373"
"2022","1","mdba","427","284","143","265","353"
"2022","1","murray river","420","215","205","218","354"
"2022","1","mdbp","247","155","92","153","230"
"2022","1","murraydarling","126","94","32","56","86"
"2022","1","river murray","104","61","43","48","73"
"2022","1","basin plan","83","67","16","19","76"
"2022","1","rivermurray","59","49","10","11","55"
"2022","1","murrayriver","46","13","33","34","35"
"2022","1","basin authority","24","20","4","6","24"
"2022","1","basinauthority","1","0","1","1","1"
"2022","1","river darling","1","0","1","1","1"
"2022","2","murray river","397","201","196","207","324"
"2022","2","mdba","395","209","186","262","290"
"2022","2","murray darling","353","278","75","95","311"
"2022","2","murray-darling","271","172","99","110","212"
"2022","2","murrayriver","233","109","124","127","94"
"2022","2","murraydarling","212","158","54","72","129"
"2022","2","mdbp","188","106","82","134","169"
"2022","2","basin plan","105","81","24","31","99"
"2022","2","river murray","76","42","34","36","58"
"2022","2","rivermurray","26","14","12","13","17"
"2022","2","basin authority","11","5","6","7","9"
"2022","2","basinplan","8","6","2","4","8"
"2022","3","murray darling","457","360","97","105","427"
"2022","3","murray river","410","212","198","213","354"
"2022","3","murray-darling","355","237","118","130","306"
"2022","3","mdba","327","124","203","274","222"
"2022","3","murraydarling","208","180","28","39","160"
"2022","3","basin plan","181","140","41","46","165"
"2022","3","mdbp","170","87","83","132","152"
"2022","3","murrayriver","83","45","38","39","73"
"2022","3","river murray","70","42","28","29","59"
"2022","3","basin authority","31","21","10","11","30"
"2022","3","rivermurray","20","5","15","17","13"
"2022","3","basinplan","2","1","1","2","2"
"2022","3","river darling","1","0","1","1","1"
"2022","3","basinauthority","1","1","0","1","1"
"2022","4","murray darling","2881","2680","201","237","1712"
"2022","4","basin plan","1670","1579","91","107","1166"
"2022","4","basin authority","1489","1372","117","125","1073"
"2022","4","mdba","1295","1035","260","336","1037"
"2022","4","murray-darling","1077","838","239","267","842"
"2022","4","murraydarling","702","627","75","86","552"
"2022","4","murray river","395","178","217","237","298"
"2022","4","mdbp","252","118","134","194","212"
"2022","4","river murray","159","117","42","46","142"
"2022","4","murrayriver","41","15","26","28","36"
"2022","4","rivermurray","19","7","12","12","14"
"2022","4","basinplan","14","5","9","9","9"
"2022","4","river darling","1","0","1","1","1"
"2022","5","murray darling","1591","1421","170","198","1226"
"2022","5","murray-darling","747","552","195","220","607"
"2022","5","murray river","574","386","188","197","511"
"2022","5","mdba","385","169","216","303","262"
"2022","5","basin authority","382","362","20","35","360"
"2022","5","basin plan","354","263","91","100","282"
"2022","5","murraydarling","211","128","83","92","140"
"2022","5","mdbp","189","93","96","152","172"
"2022","5","river murray","101","61","40","44","75"
"2022","5","murrayriver","29","8","21","21","22"
"2022","5","rivermurray","14","9","5","5","11"
"2022","5","basinplan","9","5","4","4","8"
"2022","5","basinauthority","1","0","1","1","1"
"2022","6","murray-darling","813","708","105","132","675"
"2022","6","murray darling","557","396","161","199","423"
"2022","6","murray river","444","263","181","191","383"
"2022","6","mdba","346","177","169","247","254"
"2022","6","basin plan","301","225","76","89","231"
"2022","6","mdbp","217","128","89","145","195"
"2022","6","murraydarling","176","128","48","73","113"
"2022","6","river murray","120","72","48","51","89"
"2022","6","basin authority","78","56","22","25","66"
"2022","6","murrayriver","43","11","32","35","30"
"2022","6","rivermurray","23","17","6","6","17"
"2022","6","basinplan","6","3","3","4","6"
"2022","6","river darling","1","0","1","1","1"
"2022","7","murray-darling","1259","1096","163","181","877"
"2022","7","basin plan","1111","987","124","137","813"
"2022","7","murray darling","843","687","156","173","654"
"2022","7","murray river","385","225","160","167","344"
"2022","7","mdba","331","165","166","246","228"
"2022","7","murraydarling","265","204","61","72","198"
"2022","7","mdbp","176","102","74","122","162"
"2022","7","murrayriver","49","22","27","29","30"
"2022","7","river murray","41","11","30","31","33"
"2022","7","basin authority","39","27","12","14","30"
"2022","7","rivermurray","30","18","12","12","16"
"2022","7","basinplan","7","3","4","4","7"
"2022","8","murray darling","1127","981","146","170","937"
"2022","8","murray-darling","683","455","228","244","486"
"2022","8","murray river","488","184","304","310","301"
"2022","8","basin plan","380","248","132","145","281"
"2022","8","mdba","332","153","179","249","234"
"2022","8","murraydarling","242","180","62","83","178"
"2022","8","river murray","222","172","50","54","182"
"2022","8","mdbp","212","126","86","142","191"
"2022","8","murrayriver","62","32","30","36","50"
"2022","8","basin authority","45","18","27","28","34"
"2022","8","rivermurray","25","15","10","11","20"
"2022","8","basinplan","20","14","6","7","19"
"2022","8","basinauthority","1","1","0","1","1"
"2022","9","murray river","917","608","309","322","611"
"2022","9","murray-darling","582","406","176","195","408"
"2022","9","basin plan","423","322","101","111","321"
"2022","9","mdba","341","168","173","245","252"
"2022","9","murray darling","306","223","83","100","237"
"2022","9","mdbp","197","120","77","130","172"
"2022","9","murraydarling","101","58","43","51","66"
"2022","9","river murray","93","48","45","52","63"
"2022","9","basin authority","59","29","30","30","37"
"2022","9","murrayriver","51","21","30","33","34"
"2022","9","rivermurray","25","15","10","10","15"
"2022","9","basinplan","3","2","1","2","3"
"2022","9","basinauthority","1","0","1","1","1"
"2022","10","murray river","2457","1480","977","1004","1156"
"2022","10","murray-darling","761","557","204","221","503"
"2022","10","basin plan","544","418","126","137","354"
"2022","10","murray darling","376","255","121","133","301"
"2022","10","mdba","341","179","162","227","267"
"2022","10","river murray","311","192","119","120","217"
"2022","10","murrayriver","254","112","142","147","141"
"2022","10","murraydarling","205","151","54","60","132"
"2022","10","mdbp","194","110","84","140","171"
"2022","10","basin authority","60","40","20","23","50"
"2022","10","rivermurray","47","26","21","23","35"
"2022","10","basinplan","19","11","8","8","13"
"2022","11","murray river","2014","647","1367","1395","690"
"2022","11","murray-darling","707","510","197","217","465"
"2022","11","river murray","677","389","288","291","252"
"2022","11","mdba","443","248","195","250","292"
"2022","11","basin plan","432","333","99","109","272"
"2022","11","murray darling","425","333","92","107","368"
"2022","11","mdbp","214","119","95","179","157"
"2022","11","murraydarling","173","126","47","56","111"
"2022","11","murrayriver","149","56","93","98","86"
"2022","11","basin authority","60","40","20","25","52"
"2022","11","rivermurray","57","24","33","33","35"
"2022","11","basinplan","30","18","12","13","19"
"2022","11","river darling","2","0","2","2","2"
"2022","12","river murray","1623","1013","610","628","708"
"2022","12","murray river","1590","710","880","910","764"
"2022","12","mdba","295","141","154","217","203"
"2022","12","murray-darling","248","157","91","99","211"
"2022","12","mdbp","165","86","79","141","132"
"2022","12","murray darling","164","124","40","48","147"
"2022","12","rivermurray","124","74","50","50","92"
"2022","12","murrayriver","96","41","55","65","68"
"2022","12","basin authority","61","41","20","22","57"
"2022","12","murraydarling","53","34","19","26","38"
"2022","12","basin plan","34","20","14","15","28"
"2022","12","river darling","2","0","2","2","2"
"2023","1","river murray","710","379","331","352","347"
"2023","1","murray river","486","209","277","298","362"
"2023","1","murraydarling","352","326","26","32","312"
"2023","1","mdba","251","108","143","215","179"
"2023","1","murray darling","190","129","61","69","170"
"2023","1","murray-darling","182","125","57","67","151"
"2023","1","mdbp","118","51","67","106","103"
"2023","1","murrayriver","116","50","66","71","78"
"2023","1","rivermurray","49","24","25","30","33"
"2023","1","basin plan","40","21","19","24","23"
"2023","1","basinplan","2","1","1","2","2"
"2023","1","basin authority","2","0","2","2","2"
"2023","1","river darling","2","0","2","2","2"
"2023","2","murray-darling","662","465","197","212","454"
"2023","2","murray river","340","145","195","205","274"
"2023","2","basin plan","306","173","133","138","207"
"2023","2","river murray","274","128","146","152","133"
"2023","2","mdba","245","130","115","161","197"
"2023","2","mdbp","204","109","95","128","144"
"2023","2","murray darling","173","100","73","76","147"
"2023","2","murraydarling","161","122","39","52","125"
"2023","2","murrayriver","145","60","85","90","45"
"2023","2","basinplan","22","15","7","7","21"
"2023","2","rivermurray","20","7","13","13","16"
"2023","2","basin authority","18","6","12","12","14"
"2023","2","river darling","2","1","1","1","2"
"2023","3","murraydarling","577","445","132","147","418"
"2023","3","murray darling","520","388","132","143","407"
"2023","3","murray-darling","517","391","126","141","373"
"2023","3","murray river","350","166","184","191","282"
"2023","3","mdba","311","175","136","224","228"
"2023","3","mdbp","190","96","94","148","147"
"2023","3","basin plan","135","95","40","45","115"
"2023","3","river murray","93","29","64","66","58"
"2023","3","basin authority","57","46","11","16","54"
"2023","3","murrayriver","41","12","29","32","26"
"2023","3","rivermurray","17","4","13","13","10"
"2023","3","basinplan","2","1","1","1","2"
"2023","4","murray-darling","539","422","117","131","387"
"2023","4","murray river","488","334","154","159","408"
"2023","4","mdba","288","154","134","227","199"
"2023","4","murray darling","203","137","66","77","176"
"2023","4","murraydarling","155","98","57","97","61"
"2023","4","mdbp","153","77","76","129","121"
"2023","4","river murray","135","63","72","78","98"
"2023","4","basin plan","50","17","33","35","39"
"2023","4","murrayriver","43","18","25","25","34"
"2023","4","basin authority","22","17","5","7","19"
"2023","4","rivermurray","21","15","6","9","10"
"2023","5","mdba","425","322","103","190","379"
"2023","5","mdbp","260","183","77","149","216"
"2023","5","murray river","136","38","98","110","105"
"2023","5","murray darling","125","69","56","66","106"
"2023","5","river murray","119","50","69","73","94"
"2023","5","murray-darling","100","47","53","58","83"
"2023","5","murraydarling","81","51","30","37","53"
"2023","5","basin plan","73","34","39","40","54"
"2023","5","rivermurray","15","6","9","9","10"
"2023","5","murrayriver","12","2","10","11","10"
"2023","5","basin authority","12","8","4","6","11"
"2023","5","basinplan","7","4","3","3","4"
"2023","5","river darling","1","0","1","1","1"
"2023","6","mdba","288","168","120","178","226"
"2023","6","murraydarling","265","215","50","94","136"
"2023","6","murray-darling","256","187","69","80","209"
"2023","6","mdbp","228","153","75","143","183"
"2023","6","murray river","207","80","127","131","172"
"2023","6","murray darling","173","126","47","55","146"
"2023","6","basin plan","124","72","52","60","89"
"2023","6","river murray","111","55","56","56","90"
"2023","6","basin authority","101","91","10","11","94"
"2023","6","murrayriver","34","7","27","27","18"
"2023","6","basinplan","17","11","6","7","13"
"2023","6","rivermurray","17","10","7","7","9"
"2023","6","riverdarling","1","0","1","1","1"
